11,14,12
  ########
  #  ##  #####
  #$.... #   #
  # .##....  #
  # ###$# # ##
  # .#  $ # #
###$.#$  $# #
#.      $ # #
#  $ $ $$@$ #
########  ###
       ####
