12,19,23
###################
#                 #
# $ $             #
#.# #. $ $ $ $ $  #
#.#.#.### # # ##  #
#.#.#.  $ $ $ $ $ #
#.#.#.##########  #
#.#.#. $ $ $ $ $  #
#.#.#.## # # # ## #
#.....$ $ $ $ $ $ #
#@ .###           #
##### #############

